 ________________________
|                        |
|        _____           |
|       |_o_o_|          |
|                 8      |
|                        |
|__________| |___________|


 ________________________
|                        |
|     /--\       /----\  |
|    | || |      | || |  |
|                   8    |
|  ----  ----------  --- |
|  --------------------- |
|________________________|